1111111
1000011
110N011
1110001
1000000
1111111